111111111111111111111111111111111111111111111111111111111111
1000000000C0000000011111111111111111111111111111111111111111
100P11111000000000011111111111111111111111111111111111111111
10000010000000C000011111111111111111111111111111111111111111
101000100111111110011111111111111111111111111111111111111111
1010001000C000C000011111111111111111111111111111111111111111
1C1000100011111100011111111111111111111111111111111111111111
10100000000C000000011111111111111111111111111111111111111111
10000C00001110000CE11111111111111111111111111111111111111111
111111111111111111111111111111111111111111111111111111111111