11111111111111111111
1000000000C000000001
100P1111100000000001
10000010000000C00001
10100010011111111001
1010001000C000C00001
1C100010001111110001
10100000000C00000001
10000C00001110000CE1
11111111111111111111