111111111111111111111111111111111111111111111111111111111111
1000000000C0000000011111111111111111111111111111111111111111
100011111000000000011111111111111111111111111111111111111111
10000010000000C000011111111111111111111111111111111111111111
101000100111111110011111111111111111111111111111111111111111
1010001000C000C000011111111111111111111111111111111111111111
1C1000100011111100000000000000000000000000000000001111111111
10100000000C000000000000000000000000000000000000001111111111
10000C00001110000CE00000000000000000000000000000001111111111
111111111111111111100000000000000000000000000000001111111111
111111111111111111111111111111111111111100000000001111111111
111111111111111111111111111111111111111111110000000000111111
111111111111111111111111111111111111111111111000000000011111
111111111111111111111111111111111111111111111100000000001111
111111111111111111111111111111111111111111000000000011111111
111111111111111111111111111111111111111111110000000000111111
111111111111111111111111111111111111111111000000000011111111
111111111111111111111111111111111111111111000000000011111111
111111111111111111111111111111111111111111111000000000011111
111111111111111111111111111111111111111110000000000111111111
111111111111111111111111111111111111111111000000000011111111
111111111111111111111111111111111111111111111000000000011111
111111111111111111111111111111111111111111100000000001111111
11111111111111111111111111111111111111111111100000P000011111
111111111111111111111111111111111111111111110000000000111111
111111111111111111111111111111111111111111110000000000111111
111111111111111111111111111111111111111111111000000000011111
111111111111111111111111111111111111111111100000000001111111
111111111111111111111111111111111111111111100000000001111111
111111111111111111111111111111111111111111111111111111111111